            
            
            
            
            
            
            
            
            
            
            
                             
            

            NO textures/prison_mike_400_25.xpm
SO textures/mike_nooo_400_25.xpm
WE textures/dwight_wig_400_30.xpm
EA textures/window_mike_400_25.xpm

C 50,109,168
F 6,168,15

        11111111
        101000011111111111111111111111111111111111111111111111111111111111111111111111111111111111111
        101000000000000000000000000000000000000000000000000N00000000000000000000000000000000000000001
        100010011111111111111111111111111111111111111111111111111111111111111111111111111111111111111
        1001001
        1011011
        100101
         1111111
