11111111111
10000000001
10001111001
10000001001
10000001001
10111100001
10010000001
10010000001
10000N00001
11111111111