            NO textures/wall.xpm
SO textures/5.xpm
WE textures/8.xpm
EA textures/13.xpm

F 50,168,154
C 50,109,168

11111111
10100001
10100001
10001001
10001001
10100001
100N0001
11111111
