

            NO textures/prison_mike_400_25.xpm
SO textures/mike_nooo_400_25.xpm
WE textures/dwight_wig_400_30.xpm
EA textures/window_mike_400_25.xpm

F 50,168,154
C 50,109,168

        1111111111111111111111111       11111
        1000000000110000000000001       10001
        1011000001110000000000001       10001
        1001000000000000000000001       11111
111111111011000001110000000000001
100000000011000001110111111111111
11110111111111011100000010001
11110111111111011101010010001
11000000110101011C000000C001
10000000000000001100000010001
100000000000000011010100000N1
11000001110101011111011110001
11110111 1110101 101111010001
11111111 1111111 11111111111
