            NO textures/wall.xpm
SO textures/5.xpm
WE textures/8.xpm
EA textures/13.xpm

F 50,168,154
C 50,109,168

11111
10001
10N01
10001
11111
