            NO textures/prison_mike_400_25.xpm
SO                                   textures/mike_nooo_400_25.xpm
WE textures/dwight_wig_400_30.xpm
EA textures/date_mike_400_30.xpm

F               50,168,154
                C 50,109,23


11111111111111
1000000E000001
11111111111111